1111111111111
1000000000E01
100000C0C0C01
100000P000001
1111111111111